"Division","Pool","Rank","Team","Games","Wins","Losses","GoalsFor","GoalsAgainst","GoalsDiff"
"Open Beach","Pool A","1","Disckick","3","3","0","35","13","22"
"Open Beach","Pool A","2","Hardfisch","3","2","1","28","22","6"
"Open Beach","Pool A","3","Cultimaters","3","1","2","20","31","-11"
"Open Beach","Pool A","4","Berliner Plauze","3","0","3","18","35","-17"
"Open Beach","Pool B","1","Goldfingers","3","2","1","34","21","13"
"Open Beach","Pool B","2","Drehst'n Deckel","3","2","1","30","24","6"
"Open Beach","Pool B","3","Hucks Ultimate Club Berlin","3","2","1","23","28","-5"
"Open Beach","Pool B","4","Ars Ludendi","3","0","3","18","32","-14"
"Open Beach","Finale 1-4","1","Disckick","1","1","0","13","5","8"
"Open Beach","Finale 1-4","2","Drehst'n Deckel","1","0","1","5","13","-8"
"Open Beach","Finale 1-4","3","Hardfisch","1","1","0","11","9","2"
"Open Beach","Finale 1-4","4","Goldfingers","1","0","1","9","11","-2"
"Open Beach","RR 5-8","1","Hucks Ultimate Club Berlin","3","3","0","30","24","6"
"Open Beach","RR 5-8","2","Ars Ludendi","3","1","2","27","28","-1"
"Open Beach","RR 5-8","3","Cultimaters","3","1","2","27","29","-2"
"Open Beach","RR 5-8","4","Berliner Plauze","3","1","2","26","29","-3"
"Damen Beach","Pool A","1","jinX","2","2","0","25","5","20"
"Damen Beach","Pool A","2","Goldfingers PotsDamen","2","1","1","7","15","-8"
"Damen Beach","Pool A","3","Hucks Ultimate Club Berlin","2","0","2","5","17","-12"
"Damen Beach","Rückrunde","1","jinX","4","4","0","48","19","29"
"Damen Beach","Rückrunde","2","Hucks Ultimate Club Berlin","4","1","3","20","32","-12"
"Damen Beach","Rückrunde","3","Goldfingers PotsDamen","4","1","3","20","37","-17"
"Mixed 1. Liga Beach","Pool A","1","DARKROOM Foodplay","3","3","0","39","11","28"
"Mixed 1. Liga Beach","Pool A","2","Mainzelrenner","3","2","1","28","24","4"
"Mixed 1. Liga Beach","Pool A","3","Frau Rauscher & The Bembelboys","3","1","2","23","29","-6"
"Mixed 1. Liga Beach","Pool A","4","Red Eagles","3","0","3","13","39","-26"
"Mixed 1. Liga Beach","Pool B","1","Frizzly Bears","3","3","0","39","14","25"
"Mixed 1. Liga Beach","Pool B","2","Hund Flach Werfen","3","2","1","33","32","1"
"Mixed 1. Liga Beach","Pool B","3","Endzonis","3","1","2","24","32","-8"
"Mixed 1. Liga Beach","Pool B","4","Griffins Lehre","3","0","3","20","38","-18"
"Mixed 1. Liga Beach","Finale 1-4","1","DARKROOM Foodplay","1","1","0","13","6","7"
"Mixed 1. Liga Beach","Finale 1-4","2","Hund Flach Werfen","1","0","1","6","13","-7"
"Mixed 1. Liga Beach","Finale 1-4","3","Frizzly Bears","1","1","0","12","5","7"
"Mixed 1. Liga Beach","Finale 1-4","4","Mainzelrenner","1","0","1","5","12","-7"
"Mixed 1. Liga Beach","Round Robin 5-8","1","Frau Rauscher & The Bembelboys","3","3","0","35","19","16"
"Mixed 1. Liga Beach","Round Robin 5-8","2","Endzonis","3","2","1","35","23","12"
"Mixed 1. Liga Beach","Round Robin 5-8","3","Griffins Lehre","3","1","2","22","32","-10"
"Mixed 1. Liga Beach","Round Robin 5-8","4","Red Eagles","3","0","3","20","38","-18"
"Mixed 2. Liga Beach","Pool A","1","Göttinger 7","3","3","0","37","22","15"
"Mixed 2. Liga Beach","Pool A","2","Sturmflut Hamburg","3","2","1","34","26","8"
"Mixed 2. Liga Beach","Pool A","3","Torpedo Phoenix","3","1","2","24","32","-8"
"Mixed 2. Liga Beach","Pool A","4","Rotor Ultimate Berlin","3","0","3","21","36","-15"
"Mixed 2. Liga Beach","Pool B","1","Hallunken","3","3","0","35","26","9"
"Mixed 2. Liga Beach","Pool B","2","Monaco","3","2","1","27","28","-1"
"Mixed 2. Liga Beach","Pool B","3","Saxy Divers","3","1","2","33","32","1"
"Mixed 2. Liga Beach","Pool B","4","Drehst'n Deckel","3","0","3","24","33","-9"
"Mixed 2. Liga Beach","Round Robin 1-4","1","Göttinger 7","3","2","1","36","24","12"
"Mixed 2. Liga Beach","Round Robin 1-4","2","Sturmflut Hamburg","3","2","1","30","29","1"
"Mixed 2. Liga Beach","Round Robin 1-4","3","Hallunken","3","2","1","31","27","4"
"Mixed 2. Liga Beach","Round Robin 1-4","4","Monaco","3","0","3","18","35","-17"
"Mixed 2. Liga Beach","Round Robin 5-8","1","Saxy Divers","3","3","0","38","21","17"
"Mixed 2. Liga Beach","Round Robin 5-8","2","Torpedo Phoenix","3","2","1","33","23","10"
"Mixed 2. Liga Beach","Round Robin 5-8","3","Drehst'n Deckel","3","1","2","20","34","-14"
"Mixed 2. Liga Beach","Round Robin 5-8","4","Rotor Ultimate Berlin","3","0","3","20","33","-13"
"Mixed 3. Liga Beach","Round Robin","1","Parkscheibe","3","3","0","36","13","23"
"Mixed 3. Liga Beach","Round Robin","2","Bonnsai","3","2","1","26","30","-4"
"Mixed 3. Liga Beach","Round Robin","3","Nullacht! Ultimate Münster","3","1","2","23","28","-5"
"Mixed 3. Liga Beach","Round Robin","4","HS-Ultimate","3","0","3","19","33","-14"
"Mixed 3. Liga Beach","Finale","1","Parkscheibe","1","1","0","12","5","7"
"Mixed 3. Liga Beach","Finale","2","HS-Ultimate","1","0","1","5","12","-7"
"Mixed 3. Liga Beach","Finale","3","Nullacht! Ultimate Münster","1","1","0","11","10","1"
"Mixed 3. Liga Beach","Finale","4","Bonnsai","1","0","1","10","11","-1"
"U20","Pool A","1","Lions","4","4","0","43","29","14"
"U20","Pool A","2","Äitschbees","4","3","1","34","30","4"
"U20","Pool A","3","Nullacht! Ultimate Münster","4","2","2","36","33","3"
"U20","Pool A","4","Seans's Sheep","4","1","3","30","38","-8"
"U20","Pool A","5","UFO","4","0","4","26","39","-13"
"U20","Pool B","1","Disckick","4","4","0","48","30","18"
"U20","Pool B","2","IsarRunners","4","3","1","45","26","19"
"U20","Pool B","3","TV Südkamen","4","2","2","29","38","-9"
"U20","Pool B","4","Pizza Volante","4","1","3","26","43","-17"
"U20","Pool B","5","Cologne Colibris","4","0","4","31","42","-11"
"U20","Crossover","1","Äitschbees","1","1","0","8","5","3"
"U20","Crossover","2","TV Südkamen","1","0","1","5","8","-3"
"U20","Crossover","3","IsarRunners","1","1","0","12","6","6"
"U20","Crossover","4","Nullacht! Ultimate Münster","1","0","1","6","12","-6"
"U20","Crossover","5","Seans's Sheep","1","1","0","13","4","9"
"U20","Crossover","6","Cologne Colibris","1","0","1","4","13","-9"
"U20","Crossover","7","UFO","1","1","0","10","3","7"
"U20","Crossover","8","Pizza Volante","1","0","1","3","10","-7"
"U20","Finale 1-4","1","Lions","1","1","0","9","7","2"
"U20","Finale 1-4","2","IsarRunners","1","0","1","7","9","-2"
"U20","Finale 1-4","3","Disckick","1","1","0","8","6","2"
"U20","Finale 1-4","4","Äitschbees","1","0","1","6","8","-2"
"U20","Finale 5-8","1","TV Südkamen","1","1","0","10","6","4"
"U20","Finale 5-8","2","Seans's Sheep","1","0","1","6","10","-4"
"U20","Finale 5-8","3","UFO","1","1","0","11","10","1"
"U20","Finale 5-8","4","Nullacht! Ultimate Münster","1","0","1","10","11","-1"
"U20","Finale 9-10","1","Cologne Colibris","1","1","0","10","8","2"
"U20","Finale 9-10","2","Pizza Volante","1","0","1","8","10","-2"
"U17","Pool A","1","UFO","4","4","0","48","15","33"
"U17","Pool A","2","Pizza Volante","4","3","1","37","23","14"
"U17","Pool A","3","TV Südkamen","4","2","2","31","24","7"
"U17","Pool A","4","Piratos","4","1","3","22","40","-18"
"U17","Pool A","5","Münchner Kindl","4","0","4","9","45","-36"
"U17","Pool B","1","Lions","4","4","0","43","33","10"
"U17","Pool B","2","Cologne Colibris","4","3","1","45","32","13"
"U17","Pool B","3","Äitschbees","4","2","2","42","33","9"
"U17","Pool B","4","Disckick","4","1","3","33","40","-7"
"U17","Pool B","5","Kirchheim Ultimate Juniors","4","0","4","20","45","-25"
"U17","Crossover","1","Pizza Volante","1","1","0","10","8","2"
"U17","Crossover","2","Äitschbees","1","0","1","8","10","-2"
"U17","Crossover","3","TV Südkamen","1","1","0","6","5","1"
"U17","Crossover","4","Cologne Colibris","1","0","1","5","6","-1"
"U17","Crossover","5","Kirchheim Ultimate Juniors","1","1","0","10","3","7"
"U17","Crossover","6","Piratos","1","0","1","3","10","-7"
"U17","Crossover","7","Disckick","1","1","0","13","3","10"
"U17","Crossover","8","Münchner Kindl","1","0","1","3","13","-10"
"U17","Finale 1-4","1","UFO","1","1","0","12","6","6"
"U17","Finale 1-4","2","TV Südkamen","1","0","1","6","12","-6"
"U17","Finale 1-4","3","Pizza Volante","1","1","0","8","7","1"
"U17","Finale 1-4","4","Lions","1","0","1","7","8","-1"
"U17","Finale 5-8","1","Äitschbees","1","1","0","9","7","2"
"U17","Finale 5-8","2","Kirchheim Ultimate Juniors","1","0","1","7","9","-2"
"U17","Finale 5-8","3","Disckick","1","1","0","6","5","1"
"U17","Finale 5-8","4","Cologne Colibris","1","0","1","5","6","-1"
"U17","Finale 9-10","1","Piratos","1","1","0","6","5","1"
"U17","Finale 9-10","2","Münchner Kindl","1","0","1","5","6","-1"
"U14","Pool A","1","Äitschbees","7","7","0","63","13","50"
"U14","Pool A","2","Heppie Frisbeez","7","6","1","57","19","38"
"U14","Pool A","3","Pizza Volante","7","5","2","50","35","15"
"U14","Pool A","4","Disckick","7","3","4","41","43","-2"
"U14","Pool A","5","Juniorwolves","7","3","4","45","43","2"
"U14","Pool A","6","TV Verl","7","2","5","24","57","-33"
"U14","Pool A","7","Seans's Sheep","7","2","5","23","54","-31"
"U14","Pool A","8","MuH - Mir uss Haldawang","7","0","7","21","60","-39"
"Damen 1. Liga","Pool A","1","Mainzelmädchen","7","7","0","105","45","60"
"Damen 1. Liga","Pool A","2","Heidelbärchen","7","6","1","99","82","17"
"Damen 1. Liga","Pool A","3","JinX","7","5","2","92","68","24"
"Damen 1. Liga","Pool A","4","Woodchicas","7","3","4","93","75","18"
"Damen 1. Liga","Pool A","5","Seagulls","7","3","4","81","90","-9"
"Damen 1. Liga","Pool A","6","Black Foxx","7","3","4","77","95","-18"
"Damen 1. Liga","Pool A","7","Frankas","7","1","6","56","103","-47"
"Damen 1. Liga","Pool A","8","MarGie","7","0","7","57","102","-45"
"Damen 1. Liga","Playoffs 1-4","1","Mainzelmädchen","1","1","0","15","14","1"
"Damen 1. Liga","Playoffs 1-4","2","Woodchicas","1","0","1","14","15","-1"
"Damen 1. Liga","Playoffs 1-4","3","Heidelbärchen","1","1","0","15","10","5"
"Damen 1. Liga","Playoffs 1-4","4","JinX","1","0","1","10","15","-5"
"Damen 1. Liga","Round Robin 5-8","1","Seagulls","6","6","0","81","56","25"
"Damen 1. Liga","Round Robin 5-8","2","Frankas","6","3","3","77","75","2"
"Damen 1. Liga","Round Robin 5-8","3","Black Foxx","6","3","3","65","73","-8"
"Damen 1. Liga","Round Robin 5-8","4","MarGie","6","0","6","63","82","-19"
"Damen 2. Liga Nord","Pool A","1","M-Pfau","8","7","1","115","48","67"
"Damen 2. Liga Nord","Pool A","2","U de Cologne","8","7","1","103","55","48"
"Damen 2. Liga Nord","Pool A","3","Saxy Berries","8","6","2","102","68","34"
"Damen 2. Liga Nord","Pool A","4","Gulls2Sea","8","5","3","94","79","15"
"Damen 2. Liga Nord","Pool A","5","Hucks Ultimate Club Berlin","8","4","4","95","83","12"
"Damen 2. Liga Nord","Pool A","6","Bonobos ","8","4","4","104","68","36"
"Damen 2. Liga Nord","Pool A","7","DAX","8","2","6","60","92","-32"
"Damen 2. Liga Nord","Pool A","8","Goldfingers PotsDamen","8","1","7","41","101","-60"
"Damen 2. Liga Nord","Pool A","9","Nullacht! Ultimate","8","0","8","0","120","-120"
"Damen 2. Liga Nord","Finale","1","M-Pfau","1","1","0","15","8","7"
"Damen 2. Liga Nord","Finale","2","U de Cologne","1","0","1","8","15","-7"
"Damen 2. Liga Süd","Pool A","1","GoHo Girls","5","5","0","74","27","47"
"Damen 2. Liga Süd","Pool A","2","Frau Rauscher","5","4","1","68","31","37"
"Damen 2. Liga Süd","Pool A","3","Chicyrria","5","3","2","66","40","26"
"Damen 2. Liga Süd","Pool A","4","Paradisca Jena","5","2","3","53","43","10"
"Damen 2. Liga Süd","Pool A","5","Bad Chicks","5","0","5","0","60","-60"
"Damen 2. Liga Süd","Pool A","5","Mainz Ludendi","5","0","5","0","60","-60"
"Damen 2. Liga Süd","Rückrunde","1","GoHo Girls","10","10","0","149","51","98"
"Damen 2. Liga Süd","Rückrunde","2","Frau Rauscher","10","7","3","140","68","72"
"Damen 2. Liga Süd","Rückrunde","3","Chicyrria","10","7","3","135","78","57"
"Damen 2. Liga Süd","Rückrunde","4","Paradisca Jena","10","4","6","101","88","13"
"Damen 2. Liga Süd","Rückrunde","5","Bad Chicks","10","0","10","0","120","-120"
"Damen 2. Liga Süd","Rückrunde","5","Mainz Ludendi","10","0","10","0","120","-120"
"Open 1. Liga","Vorrunde A","1","Bad Skid","7","7","0","105","55","50"
"Open 1. Liga","Vorrunde A","2","Heidees","7","5","2","92","92","0"
"Open 1. Liga","Vorrunde A","3"," Frizzly Bears","7","4","3","89","86","3"
"Open 1. Liga","Vorrunde A","4","BORA","7","4","3","93","86","7"
"Open 1. Liga","Vorrunde A","5","Hässliche Erdferkel","7","4","3","93","89","4"
"Open 1. Liga","Vorrunde A","6","Frank N.","7","3","4","87","92","-5"
"Open 1. Liga","Vorrunde A","7","Hucks Ultimate Berlin","7","1","6","72","104","-32"
"Open 1. Liga","Vorrunde A","8","Kiel2","7","0","7","78","105","-27"
"Open 1. Liga","Vorrunde B","1","Wall City","7","7","0","105","79","26"
"Open 1. Liga","Vorrunde B","2","7Schwaben","7","6","1","103","71","32"
"Open 1. Liga","Vorrunde B","3","M.U.C.","7","5","2","100","82","18"
"Open 1. Liga","Vorrunde B","4","Ars Ludendi","7","4","3","94","90","4"
"Open 1. Liga","Vorrunde B","5","Hardfisch","7","2","5","87","94","-7"
"Open 1. Liga","Vorrunde B","6","GeRey","7","2","5","83","94","-11"
"Open 1. Liga","Vorrunde B","7","Family Ultimate","7","2","5","82","97","-15"
"Open 1. Liga","Vorrunde B","8","Funatics","7","0","7","58","105","-47"
"Open 1. Liga","Top 8","1","Bad Skid","1","1","0","15","8","7"
"Open 1. Liga","Top 8","2","Ars Ludendi","1","0","1","8","15","-7"
"Open 1. Liga","Top 8","3","7Schwaben","1","1","0","15","9","6"
"Open 1. Liga","Top 8","4"," Frizzly Bears","1","0","1","9","15","-6"
"Open 1. Liga","Top 8","5","Wall City","1","1","0","15","14","1"
"Open 1. Liga","Top 8","6","BORA","1","0","1","14","15","-1"
"Open 1. Liga","Top 8","7","M.U.C.","1","1","0","15","11","4"
"Open 1. Liga","Top 8","8","Heidees","1","0","1","11","15","-4"
"Open 1. Liga","Top 8 Semifinals","1","Bad Skid","1","1","0","15","9","6"
"Open 1. Liga","Top 8 Semifinals","2","7Schwaben","1","0","1","9","15","-6"
"Open 1. Liga","Top 8 Semifinals","3","M.U.C.","1","1","0","15","10","5"
"Open 1. Liga","Top 8 Semifinals","4","Wall City","1","0","1","10","15","-5"
"Open 1. Liga","Top 8 Semifinals","5","Ars Ludendi","1","1","0","15","14","1"
"Open 1. Liga","Top 8 Semifinals","6"," Frizzly Bears","1","0","1","14","15","-1"
"Open 1. Liga","Top 8 Semifinals","7","Heidees","1","1","0","15","9","6"
"Open 1. Liga","Top 8 Semifinals","8","BORA","1","0","1","9","15","-6"
"Open 1. Liga","Top 8 Finals","1","Bad Skid","1","1","0","15","8","7"
"Open 1. Liga","Top 8 Finals","2","M.U.C.","1","0","1","8","15","-7"
"Open 1. Liga","Top 8 Finals","3","7Schwaben","1","1","0","15","14","1"
"Open 1. Liga","Top 8 Finals","4","Wall City","1","0","1","14","15","-1"
"Open 1. Liga","Top 8 Finals","5","Heidees","1","1","0","15","14","1"
"Open 1. Liga","Top 8 Finals","6","Ars Ludendi","1","0","1","14","15","-1"
"Open 1. Liga","Top 8 Finals","7"," Frizzly Bears","1","1","0","15","7","8"
"Open 1. Liga","Top 8 Finals","8","BORA","1","0","1","7","15","-8"
"Open 1. Liga","Zwischen C","1","Hässliche Erdferkel","3","3","0","45","32","13"
"Open 1. Liga","Zwischen C","2","GeRey","3","2","1","39","34","5"
"Open 1. Liga","Zwischen C","3","Funatics","3","1","2","36","42","-6"
"Open 1. Liga","Zwischen C","4","Hucks Ultimate Berlin","3","0","3","32","44","-12"
"Open 1. Liga","Zwischen D","1","Hardfisch","3","2","1","41","32","9"
"Open 1. Liga","Zwischen D","2","Frank N.","3","2","1","40","34","6"
"Open 1. Liga","Zwischen D","3","Kiel2","3","1","2","33","44","-11"
"Open 1. Liga","Zwischen D","4","Family Ultimate","3","1","2","37","41","-4"
"Open 1. Liga","Spiel um Platz 9","1","Hardfisch","1","1","0","15","12","3"
"Open 1. Liga","Spiel um Platz 9","2","Hässliche Erdferkel","1","0","1","12","15","-3"
"Open 1. Liga","Relegationsspiel (Platz 11)","1","GeRey","1","1","0","15","13","2"
"Open 1. Liga","Relegationsspiel (Platz 11)","2","Kiel2","1","0","1","13","15","-2"
"Open 1. Liga","Relegationsspiel (Platz 11)","3","Frank N.","1","1","0","15","3","12"
"Open 1. Liga","Relegationsspiel (Platz 11)","4","Funatics","1","0","1","3","15","-12"
"Open 1. Liga","Spiel um Platz 15","1","Hucks Ultimate Berlin","1","1","0","15","0","15"
"Open 1. Liga","Spiel um Platz 15","2","Family Ultimate","1","0","1","0","15","-15"
"Open 2. Liga Nord","Vorrunde A","1","Deine Mudder Bremen","7","7","0","102","72","30"
"Open 2. Liga Nord","Vorrunde A","2","Goldfingers","7","6","1","100","66","34"
"Open 2. Liga Nord","Vorrunde A","3","Drehst'n Deckel","7","5","2","95","72","23"
"Open 2. Liga Nord","Vorrunde A","4","Hard2Fisch","7","4","3","95","78","17"
"Open 2. Liga Nord","Vorrunde A","5","Caracals","7","3","4","89","89","0"
"Open 2. Liga Nord","Vorrunde A","6","Frühsport 0,2","7","2","5","63","94","-31"
"Open 2. Liga Nord","Vorrunde A","7","TeKielas","7","1","6","74","99","-25"
"Open 2. Liga Nord","Vorrunde A","8","Disckick","7","0","7","54","102","-48"
"Open 2. Liga Nord","Top 4","1","Goldfingers","6","5","1","85","69","16"
"Open 2. Liga Nord","Top 4","2","Deine Mudder Bremen","6","5","1","85","70","15"
"Open 2. Liga Nord","Top 4","3","Drehst'n Deckel","6","1","5","71","86","-15"
"Open 2. Liga Nord","Top 4","4","Hard2Fisch","6","1","5","69","85","-16"
"Open 2. Liga Nord","Bottom 4","1","Frühsport 0,2","6","5","1","80","68","12"
"Open 2. Liga Nord","Bottom 4","2","Caracals","6","4","2","85","62","23"
"Open 2. Liga Nord","Bottom 4","3","TeKielas","6","2","4","65","81","-16"
"Open 2. Liga Nord","Bottom 4","4","Disckick","6","1","5","65","84","-19"
"Open 2. Liga Süd","Vorrunde A","1","Bad Raps","7","7","0","105","71","34"
"Open 2. Liga Süd","Vorrunde A","2","Gummibärchen","7","6","1","99","60","39"
"Open 2. Liga Süd","Vorrunde A","3","Wolpertinger","7","4","3","100","77","23"
"Open 2. Liga Süd","Vorrunde A","4","Force Middle","7","3","4","85","89","-4"
"Open 2. Liga Süd","Vorrunde A","5","THW","7","3","4","80","87","-7"
"Open 2. Liga Süd","Vorrunde A","6","Feldrenner","7","2","5","64","98","-34"
"Open 2. Liga Süd","Vorrunde A","7","2MUCL","7","2","5","79","95","-16"
"Open 2. Liga Süd","Vorrunde A","8","7Schwaben II","7","1","6","69","104","-35"
"Open 2. Liga Süd","Top 4","1","Bad Raps","6","6","0","90","68","22"
"Open 2. Liga Süd","Top 4","2","Gummibärchen","6","4","2","81","69","12"
"Open 2. Liga Süd","Top 4","3","Wolpertinger","6","2","4","75","84","-9"
"Open 2. Liga Süd","Top 4","4","Force Middle","6","0","6","65","90","-25"
"Open 2. Liga Süd","Bottom 4","1","THW","6","6","0","86","55","31"
"Open 2. Liga Süd","Bottom 4","2","Feldrenner","6","3","3","80","77","3"
"Open 2. Liga Süd","Bottom 4","3","2MUCL","6","3","3","80","70","10"
"Open 2. Liga Süd","Bottom 4","4","7Schwaben II","6","0","6","46","90","-44"
"Open 3. Liga NW","Pool A","1","Bonnsai","4","4","0","60","28","32"
"Open 3. Liga NW","Pool A","2","DU bist Frisbee","4","3","1","55","40","15"
"Open 3. Liga NW","Pool A","3","Bonobos","4","2","2","56","33","23"
"Open 3. Liga NW","Pool A","4","Die 7 Todsünden","4","1","3","23","53","-30"
"Open 3. Liga NW","Pool A","5","Frisbielefeld","4","0","4","20","60","-40"
"Open 3. Liga NW","Finale","1","Bonnsai","1","1","0","15","9","6"
"Open 3. Liga NW","Finale","2","DU bist Frisbee","1","0","1","9","15","-6"
"Open 3. Liga NO","Pool A","1","Mad Squid","5","5","0","74","34","40"
"Open 3. Liga NO","Pool A","2","EazyEastKoast","5","4","1","68","43","25"
"Open 3. Liga NO","Pool A","3","DJ Dahlem","5","3","2","66","49","17"
"Open 3. Liga NO","Pool A","4","Mitteldeutscher Rundflug","5","2","3","58","57","1"
"Open 3. Liga NO","Pool A","5","MULe","5","1","4","52","60","-8"
"Open 3. Liga NO","Pool A","6","Schleudertrauma","5","0","5","0","75","-75"
"Open 3. Liga NO","Rückrunde","1","Mad Squid","10","10","0","149","57","92"
"Open 3. Liga NO","Rückrunde","2","EazyEastKoast","10","8","2","140","84","56"
"Open 3. Liga NO","Rückrunde","3","MULe","10","4","6","110","107","3"
"Open 3. Liga NO","Rückrunde","4","Mitteldeutscher Rundflug","10","4","6","114","110","4"
"Open 3. Liga NO","Rückrunde","5","DJ Dahlem","10","4","6","104","109","-5"
"Open 3. Liga NO","Rückrunde","6","Schleudertrauma","10","0","10","0","150","-150"
"Open 3. Liga Süd","Pool A","1","Paradisco","5","5","0","75","34","41"
"Open 3. Liga Süd","Pool A","2","Sturm und Drang","5","4","1","73","42","31"
"Open 3. Liga Süd","Pool A","3","Schwabing Frisbee Buam e.V.","5","3","2","60","60","0"
"Open 3. Liga Süd","Pool A","4","Spice Boyz","5","2","3","44","66","-22"
"Open 3. Liga Süd","Pool A","5","Wer(f)wölfle","5","1","4","49","72","-23"
"Open 3. Liga Süd","Pool A","6","FrankPauli","5","0","5","48","75","-27"
"Open 3. Liga Süd","Rückrunde","1","Sturm und Drang","10","9","1","146","72","74"
"Open 3. Liga Süd","Rückrunde","2","Paradisco","10","8","2","144","91","53"
"Open 3. Liga Süd","Rückrunde","3","Wer(f)wölfle","10","5","5","116","126","-10"
"Open 3. Liga Süd","Rückrunde","4","Schwabing Frisbee Buam e.V.","10","4","6","110","131","-21"
"Open 3. Liga Süd","Rückrunde","5","Spice Boyz","10","3","7","87","138","-51"
"Open 3. Liga Süd","Rückrunde","6","FrankPauli","10","1","9","97","142","-45"
"Mixed 1. Liga","Pool A","1","Sugar Mix","7","6","1","103","73","30"
"Mixed 1. Liga","Pool A","2","Colorado","7","6","1","102","65","37"
"Mixed 1. Liga","Pool A","3","Sturmflut","7","4","3","91","85","6"
"Mixed 1. Liga","Pool A","4","Die 7 Todsünden","7","4","3","99","83","16"
"Mixed 1. Liga","Pool A","5","Tiefseetaucher","7","3","4","83","96","-13"
"Mixed 1. Liga","Pool A","6","Disckick","7","3","4","79","97","-18"
"Mixed 1. Liga","Pool A","7","ULMtimates","7","2","5","82","97","-15"
"Mixed 1. Liga","Pool A","8","Disc-o-Fever","7","0","7","62","105","-43"
"Mixed 1. Liga","Pool B","1","Ars Ludendi","7","6","1","103","75","28"
"Mixed 1. Liga","Pool B","2","Hässliche Erdferkel","7","5","2","98","81","17"
"Mixed 1. Liga","Pool B","3","Disconnection","7","5","2","97","83","14"
"Mixed 1. Liga","Pool B","4","Mainzelrenner","7","5","2","96","79","17"
"Mixed 1. Liga","Pool B","5","Deine Mudder","7","3","4","86","91","-5"
"Mixed 1. Liga","Pool B","6","Frau Rauscher & the Bembelboys","7","2","5","75","96","-21"
"Mixed 1. Liga","Pool B","7","Maultaschen","7","2","5","84","92","-8"
"Mixed 1. Liga","Pool B","8","Zamperl","7","0","7","63","105","-42"
"Mixed 1. Liga","Playoffs 1-8","1","Sugar Mix","1","0","1","12","15","-3"
"Mixed 1. Liga","Playoffs 1-8","1","Mainzelrenner","1","1","0","15","12","3"
"Mixed 1. Liga","Playoffs 1-8","3","Hässliche Erdferkel","1","1","0","15","13","2"
"Mixed 1. Liga","Playoffs 1-8","4","Sturmflut","1","0","1","13","15","-2"
"Mixed 1. Liga","Playoffs 1-8","5","Ars Ludendi","1","1","0","13","9","4"
"Mixed 1. Liga","Playoffs 1-8","6","Die 7 Todsünden","1","0","1","9","13","-4"
"Mixed 1. Liga","Playoffs 1-8","7","Colorado","1","1","0","15","10","5"
"Mixed 1. Liga","Playoffs 1-8","8","Disconnection","1","0","1","10","15","-5"
"Mixed 1. Liga","Playoffs 1-8 Semifinals","1","Mainzelrenner","1","1","0","15","12","3"
"Mixed 1. Liga","Playoffs 1-8 Semifinals","2","Hässliche Erdferkel","1","0","1","12","15","-3"
"Mixed 1. Liga","Playoffs 1-8 Semifinals","3","Colorado","1","1","0","15","14","1"
"Mixed 1. Liga","Playoffs 1-8 Semifinals","4","Ars Ludendi","1","0","1","14","15","-1"
"Mixed 1. Liga","Playoffs 1-8 Semifinals","5","Sugar Mix","1","1","0","15","10","5"
"Mixed 1. Liga","Playoffs 1-8 Semifinals","6","Sturmflut","1","0","1","10","15","-5"
"Mixed 1. Liga","Playoffs 1-8 Semifinals","7","Disconnection","1","1","0","15","8","7"
"Mixed 1. Liga","Playoffs 1-8 Semifinals","8","Die 7 Todsünden","1","0","1","8","15","-7"
"Mixed 1. Liga","Playoffs 1-8 Finals","1","Colorado","1","1","0","15","14","1"
"Mixed 1. Liga","Playoffs 1-8 Finals","2","Mainzelrenner","1","0","1","14","15","-1"
"Mixed 1. Liga","Playoffs 1-8 Finals","3","Ars Ludendi","1","1","0","15","10","5"
"Mixed 1. Liga","Playoffs 1-8 Finals","4","Hässliche Erdferkel","1","0","1","10","15","-5"
"Mixed 1. Liga","Playoffs 1-8 Finals","5","Disconnection","1","1","0","15","8","7"
"Mixed 1. Liga","Playoffs 1-8 Finals","6","Sugar Mix","1","0","1","8","15","-7"
"Mixed 1. Liga","Playoffs 1-8 Finals","7","Die 7 Todsünden","1","1","0","14","9","5"
"Mixed 1. Liga","Playoffs 1-8 Finals","8","Sturmflut","1","0","1","9","14","-5"
"Mixed 1. Liga","Pool C","1","Frau Rauscher & the Bembelboys","3","2","1","42","38","4"
"Mixed 1. Liga","Pool C","2","Zamperl","3","2","1","40","36","4"
"Mixed 1. Liga","Pool C","3","ULMtimates","3","2","1","39","37","2"
"Mixed 1. Liga","Pool C","4","Tiefseetaucher","3","0","3","35","45","-10"
"Mixed 1. Liga","Pool D","1","Disckick","3","2","1","40","36","4"
"Mixed 1. Liga","Pool D","2","Maultaschen","3","2","1","41","32","9"
"Mixed 1. Liga","Pool D","3","Deine Mudder","3","2","1","39","39","0"
"Mixed 1. Liga","Pool D","4","Disc-o-Fever","3","0","3","32","45","-13"
"Mixed 1. Liga","Spiel um Platz 9","1","Frau Rauscher & the Bembelboys","1","1","0","14","12","2"
"Mixed 1. Liga","Spiel um Platz 9","2","Disckick","1","0","1","12","14","-2"
"Mixed 1. Liga","Relegationsspiele (11-14)","1","Deine Mudder","1","1","0","13","7","6"
"Mixed 1. Liga","Relegationsspiele (11-14)","2","Zamperl","1","0","1","7","13","-6"
"Mixed 1. Liga","Relegationsspiele (11-14)","3","Maultaschen","1","1","0","15","10","5"
"Mixed 1. Liga","Relegationsspiele (11-14)","4","ULMtimates","1","0","1","10","15","-5"
"Mixed 1. Liga","Spiel um Platz 15","1","Disc-o-Fever","1","1","0","15","14","1"
"Mixed 1. Liga","Spiel um Platz 15","2","Tiefseetaucher","1","0","1","14","15","-1"
"Mixed 2. Liga Nord","Pool A","1","Nullacht! Ultimate Münster","7","7","0","102","51","51"
"Mixed 2. Liga Nord","Pool A","2","Tekielas","7","5","2","95","76","19"
"Mixed 2. Liga Nord","Pool A","3","Hucks Ultimate Club Berlin","7","5","2","100","62","38"
"Mixed 2. Liga Nord","Pool A","4","Bonobos","7","4","3","87","65","22"
"Mixed 2. Liga Nord","Pool A","5","Frizzly Bears","7","3","4","74","73","1"
"Mixed 2. Liga Nord","Pool A","6","Family Ultimate","7","3","4","82","78","4"
"Mixed 2. Liga Nord","Pool A","7","Frühmix","7","1","6","60","90","-30"
"Mixed 2. Liga Nord","Pool A","8","Endzonis","7","0","7","0","105","-105"
"Mixed 2. Liga Nord","Round Robin 1-4","1","Nullacht! Ultimate Münster","6","5","1","85","62","23"
"Mixed 2. Liga Nord","Round Robin 1-4","2","Hucks Ultimate Club Berlin","6","4","2","85","65","20"
"Mixed 2. Liga Nord","Round Robin 1-4","3","Bonobos","6","2","4","57","74","-17"
"Mixed 2. Liga Nord","Round Robin 1-4","4","Tekielas","6","1","5","63","89","-26"
"Mixed 2. Liga Nord","Round Robin 5-8","1","Frizzly Bears","6","6","0","90","36","54"
"Mixed 2. Liga Nord","Round Robin 5-8","2","Family Ultimate","6","3","3","76","52","24"
"Mixed 2. Liga Nord","Round Robin 5-8","3","Frühmix","6","3","3","70","58","12"
"Mixed 2. Liga Nord","Round Robin 5-8","4","Endzonis","6","0","6","0","90","-90"
"Mixed 2. Liga Süd","Pool A","1","Monaco Mix","7","7","0","105","54","51"
"Mixed 2. Liga Süd","Pool A","2","Next Generation","7","4","3","92","78","14"
"Mixed 2. Liga Süd","Pool A","3","Team Südsee","7","4","3","86","83","3"
"Mixed 2. Liga Süd","Pool A","4","Frisbee Fieber","7","4","3","91","86","5"
"Mixed 2. Liga Süd","Pool A","5","Paradisco Jena","7","3","4","86","91","-5"
"Mixed 2. Liga Süd","Pool A","6","Wurfkultur Bamberg","7","3","4","81","88","-7"
"Mixed 2. Liga Süd","Pool A","7","Heidees","7","2","5","74","97","-23"
"Mixed 2. Liga Süd","Pool A","8","Colorados","7","1","6","66","104","-38"
"Mixed 2. Liga Süd","Round Robin 1-4","1","Monaco Mix","6","5","1","86","62","24"
"Mixed 2. Liga Süd","Round Robin 1-4","2","Next Generation","6","5","1","84","69","15"
"Mixed 2. Liga Süd","Round Robin 1-4","3","Frisbee Fieber","6","1","5","64","84","-20"
"Mixed 2. Liga Süd","Round Robin 1-4","4","Team Südsee","6","1","5","62","81","-19"
"Mixed 2. Liga Süd","Round Robin 5-8","1","Wurfkultur Bamberg","6","4","2","84","68","16"
"Mixed 2. Liga Süd","Round Robin 5-8","2","Paradisco Jena","6","4","2","82","69","13"
"Mixed 2. Liga Süd","Round Robin 5-8","3","Colorados","6","2","4","69","85","-16"
"Mixed 2. Liga Süd","Round Robin 5-8","4","Heidees","6","2","4","71","84","-13"
"Mixed 3. Liga NW","Pool A","1","Göttinger 7","7","7","0","104","51","53"
"Mixed 3. Liga NW","Pool A","2","Hamburg Sturmflut 2","7","5","2","98","69","29"
"Mixed 3. Liga NW","Pool A","3","Bonnsai","7","5","2","90","63","27"
"Mixed 3. Liga NW","Pool A","4","Funatics","7","3","4","76","89","-13"
"Mixed 3. Liga NW","Pool A","5","Endzonengammler Essen","7","3","4","77","95","-18"
"Mixed 3. Liga NW","Pool A","6","DU bist Frisbee","7","3","4","84","94","-10"
"Mixed 3. Liga NW","Pool A","7","Fischkutter","7","1","6","63","102","-39"
"Mixed 3. Liga NW","Pool A","8","Hamburg Alsters","7","1","6","71","100","-29"
"Mixed 3. Liga NW","Playoffs 1-4","1","Göttinger 7","1","1","0","15","8","7"
"Mixed 3. Liga NW","Playoffs 1-4","2","Funatics","1","0","1","8","15","-7"
"Mixed 3. Liga NW","Playoffs 1-4","3","Bonnsai","1","1","0","15","10","5"
"Mixed 3. Liga NW","Playoffs 1-4","4","Hamburg Sturmflut 2","1","0","1","10","15","-5"
"Mixed 3. Liga NW","Round Robin 1-4","1","DU bist Frisbee","6","5","1","88","70","18"
"Mixed 3. Liga NW","Round Robin 1-4","2","Endzonengammler Essen","6","3","3","79","72","7"
"Mixed 3. Liga NW","Round Robin 1-4","3","Fischkutter","6","2","4","57","82","-25"
"Mixed 3. Liga NW","Round Robin 1-4","4","Hamburg Alsters","6","2","4","76","76","0"
"Mixed 3. Liga NO","Pool A","1","BRLO Ultmte Berlin","7","7","0","105","51","54"
"Mixed 3. Liga NO","Pool A","2","Saxy Divers","7","6","1","92","71","21"
"Mixed 3. Liga NO","Pool A","3","Hallunken","7","4","3","90","78","12"
"Mixed 3. Liga NO","Pool A","4","Hund Flach Werfen","7","4","3","95","72","23"
"Mixed 3. Liga NO","Pool A","5","Drehst'n Deckel","7","4","3","80","87","-7"
"Mixed 3. Liga NO","Pool A","6","Red Eagles","7","2","5","70","98","-28"
"Mixed 3. Liga NO","Pool A","7","Goldfingers","7","1","6","69","100","-31"
"Mixed 3. Liga NO","Pool A","8","Griffin's Lehre","7","0","7","61","105","-44"
"Mixed 3. Liga NO","Playoffs 1-4","1","BRLO Ultmte Berlin","1","1","0","15","10","5"
"Mixed 3. Liga NO","Playoffs 1-4","2","Hund Flach Werfen","1","0","1","10","15","-5"
"Mixed 3. Liga NO","Playoffs 1-4","3","Hallunken","1","1","0","13","11","2"
"Mixed 3. Liga NO","Playoffs 1-4","4","Saxy Divers","1","0","1","11","13","-2"
"Mixed 3. Liga NO","Playoffs 1-4 Finals","1","BRLO Ultmte Berlin","1","1","0","15","2","13"
"Mixed 3. Liga NO","Playoffs 1-4 Finals","2","Hallunken","1","0","1","2","15","-13"
"Mixed 3. Liga NO","Playoffs 1-4 Finals","3","Hund Flach Werfen","1","1","0","15","13","2"
"Mixed 3. Liga NO","Playoffs 1-4 Finals","4","Saxy Divers","1","0","1","13","15","-2"
"Mixed 3. Liga NO","Round Robin 5-8","1","Drehst'n Deckel","6","5","1","85","62","23"
"Mixed 3. Liga NO","Round Robin 5-8","2","Red Eagles","6","4","2","78","75","3"
"Mixed 3. Liga NO","Round Robin 5-8","3","Griffin's Lehre","6","2","4","69","79","-10"
"Mixed 3. Liga NO","Round Robin 5-8","4","Goldfingers","6","1","5","66","82","-16"
"Mixed 3. Liga SW","Pool A","1","Ars Ludendi","5","4","1","68","38","30"
"Mixed 3. Liga SW","Pool A","2","Feldmädchen","5","4","1","58","49","9"
"Mixed 3. Liga SW","Pool A","3","Flying Igels","5","3","2","57","51","6"
"Mixed 3. Liga SW","Pool A","4","Himmelstürmer","5","2","3","53","60","-7"
"Mixed 3. Liga SW","Pool A","5","Hechte","5","1","4","43","63","-20"
"Mixed 3. Liga SW","Pool A","6","Friendly Fire","5","1","4","50","68","-18"
"Mixed 3. Liga SW","Runde 2","1","Ars Ludendi","10","9","1","143","85","58"
"Mixed 3. Liga SW","Runde 2","2","Feldmädchen","10","7","3","122","109","13"
"Mixed 3. Liga SW","Runde 2","3","Himmelstürmer","10","5","5","122","114","8"
"Mixed 3. Liga SW","Runde 2","4","Flying Igels","10","5","5","115","113","2"
"Mixed 3. Liga SW","Runde 2","5","Hechte","10","2","8","88","130","-42"
"Mixed 3. Liga SW","Runde 2","6","Friendly Fire","10","2","8","100","139","-39"
"Mixed 3. Liga SO","Pool A","1","MINT","4","4","0","57","15","42"
"Mixed 3. Liga SO","Pool A","2","Ratisbona Eagles","4","3","1","49","19","30"
"Mixed 3. Liga SO","Pool A","3","Seichtwasserschnorchler","4","2","2","38","39","-1"
"Mixed 3. Liga SO","Pool A","4","Unwucht","4","1","3","33","44","-11"
"Mixed 3. Liga SO","Pool A","5","Ultimate am See","4","0","4","0","60","-60"
"Mixed 3. Liga SO","Rückrunde","1","MINT","8","8","0","114","40","74"
"Mixed 3. Liga SO","Rückrunde","2","Ratisbona Eagles","8","6","2","107","44","63"
"Mixed 3. Liga SO","Rückrunde","3","Seichtwasserschnorchler","8","4","4","80","76","4"
"Mixed 3. Liga SO","Rückrunde","4","Unwucht","8","2","6","68","89","-21"
"Mixed 3. Liga SO","Rückrunde","5","Ultimate am See","8","0","8","0","120","-120"
"Mixed 4. Liga NW","Round-Robin","1","Torpedo Phoenix","2","2","0","30","9","21"
"Mixed 4. Liga NW","Round-Robin","2","Farmers Lüneburg","2","1","1","19","26","-7"
"Mixed 4. Liga NW","Round-Robin","3","Nullacht! Ultimate Münster II","2","0","2","16","30","-14"
"Mixed 4. Liga NW","Rückrunde","1","Torpedo Phoenix","4","4","0","60","18","42"
"Mixed 4. Liga NW","Rückrunde","2","Farmers Lüneburg","4","2","2","39","49","-10"
"Mixed 4. Liga NW","Rückrunde","3","Nullacht! Ultimate Münster II","4","0","4","28","60","-32"
"Mixed 4. Liga NO","Pool A","1","Schleudertrauma","4","3","1","54","29","25"
"Mixed 4. Liga NO","Pool A","2","RotoR Ultimate Berlin","4","3","1","52","30","22"
"Mixed 4. Liga NO","Pool A","3","Parkscheibe","4","3","1","50","29","21"
"Mixed 4. Liga NO","Pool A","4","DiscUrs","4","1","3","37","45","-8"
"Mixed 4. Liga NO","Pool A","5","Stoneheads","4","0","4","0","60","-60"
"Mixed 4. Liga NO","Rückrunde","1","Parkscheibe","8","7","1","109","56","53"
"Mixed 4. Liga NO","Rückrunde","2","RotoR Ultimate Berlin","8","5","3","102","64","38"
"Mixed 4. Liga NO","Rückrunde","3","Schleudertrauma","8","5","3","101","70","31"
"Mixed 4. Liga NO","Rückrunde","4","DiscUrs","8","3","5","86","88","-2"
"Mixed 4. Liga NO","Rückrunde","5","Stoneheads","8","0","8","0","120","-120"
"Mixed Masters","Round Robin","1","Goldfingers","3","2","1","42","26","16"
"Mixed Masters","Round Robin","2","TiB Mixed Masters","3","2","1","35","32","3"
"Mixed Masters","Round Robin","3","Old Main Line","3","2","1","37","36","1"
"Mixed Masters","Round Robin","4","Torpedo Phoenix","3","0","3","25","45","-20"
"Mixed Masters","Playoffs","1","Goldfingers","1","1","0","15","3","12"
"Mixed Masters","Playoffs","2","Torpedo Phoenix","1","0","1","3","15","-12"
"Mixed Masters","Playoffs","3","TiB Mixed Masters","1","1","0","15","12","3"
"Mixed Masters","Playoffs","4","Old Main Line","1","0","1","12","15","-3"
"Open Masters","Round Robin","1","Goldfingers","4","4","0","60","30","30"
"Open Masters","Round Robin","2","Heidees","4","3","1","55","47","8"
"Open Masters","Round Robin","3","Sugar Daddies","4","2","2","45","47","-2"
"Open Masters","Round Robin","4","Family Ultimate","4","1","3","38","59","-21"
"Open Masters","Round Robin","5","Frühsport 0,2","4","0","4","45","60","-15"
"Open Masters","Finale","1","Goldfingers","1","1","0","15","11","4"
"Open Masters","Finale","2","Heidees","1","0","1","11","15","-4"
"Open Grandmasters","Round Robin","1","Feldrentner","4","4","0","60","35","25"
"Open Grandmasters","Round Robin","2","Wolpertinger GM","4","3","1","52","42","10"
"Open Grandmasters","Round Robin","3","NextGen Nürnberg","4","2","2","54","47","7"
"Open Grandmasters","Round Robin","4","TeKielas","4","1","3","37","59","-22"
"Open Grandmasters","Round Robin","5","Wegwerfgesellschaft","4","0","4","40","60","-20"
"Open Grandmasters","Finale","1","Feldrentner","1","1","0","15","7","8"
"Open Grandmasters","Finale","2","Wolpertinger GM","1","0","1","7","15","-8"
"DFV-Pokal Open","Vorrunde 1","1"," Bad Skid","1","1","0","15","5","10"
"DFV-Pokal Open","Vorrunde 1","2","Wall City","1","0","1","5","15","-10"
"DFV-Pokal Open","Vorrunde 1","3","M.U.C.","1","1","0","15","7","8"
"DFV-Pokal Open","Vorrunde 1","4","Hässliche Erdferkel","1","0","1","7","15","-8"
"DFV-Pokal Open","Vorrunde 1","5","Heidees","1","1","0","15","13","2"
"DFV-Pokal Open","Vorrunde 1","6","Family Ultimate","1","0","1","13","15","-2"
"DFV-Pokal Open","Vorrunde 1","7","FrankN","1","1","0","15","13","2"
"DFV-Pokal Open","Vorrunde 1","8","7 Schwaben","1","0","1","13","15","-2"
"DFV-Pokal Open","Vorrunde 1","9","Frizzly Bears","1","1","0","15","9","6"
"DFV-Pokal Open","Vorrunde 1","10","2MUCL","1","0","1","9","15","-6"
"DFV-Pokal Open","Vorrunde 1","11","Hardfisch","1","1","0","15","8","7"
"DFV-Pokal Open","Vorrunde 1","12","Disckick","1","0","1","8","15","-7"
"DFV-Pokal Open","Vorrunde 1","13","Hucks Ultimate Berlin","1","1","0","15","12","3"
"DFV-Pokal Open","Vorrunde 1","14","Kiel2","1","0","1","12","15","-3"
"DFV-Pokal Open","Vorrunde 1","15","Ars Ludendi","1","1","0","15","8","7"
"DFV-Pokal Open","Vorrunde 1","16","Funatics","1","0","1","8","15","-7"
"DFV-Pokal Open","Vorrunde 2","1"," Bad Skid","1","1","0","15","8","7"
"DFV-Pokal Open","Vorrunde 2","2","Heidees","1","0","1","8","15","-7"
"DFV-Pokal Open","Vorrunde 2","3","M.U.C.","1","1","0","15","10","5"
"DFV-Pokal Open","Vorrunde 2","4","FrankN","1","0","1","10","15","-5"
"DFV-Pokal Open","Vorrunde 2","5","7 Schwaben","1","1","0","15","5","10"
"DFV-Pokal Open","Vorrunde 2","6","Hucks Ultimate Berlin","1","0","1","5","15","-10"
"DFV-Pokal Open","Vorrunde 2","7","Family Ultimate","1","1","0","15","10","5"
"DFV-Pokal Open","Vorrunde 2","8","Ars Ludendi","1","0","1","10","15","-5"
"DFV-Pokal Open","Vorrunde 2","9","Frizzly Bears","1","1","0","15","13","2"
"DFV-Pokal Open","Vorrunde 2","10","Hässliche Erdferkel","1","0","1","13","15","-2"
"DFV-Pokal Open","Vorrunde 2","11","Hardfisch","1","1","0","15","14","1"
"DFV-Pokal Open","Vorrunde 2","12","Wall City","1","0","1","14","15","-1"
"DFV-Pokal Open","Vorrunde 2","13","Disckick","1","1","0","15","9","6"
"DFV-Pokal Open","Vorrunde 2","14","Funatics","1","0","1","9","15","-6"
"DFV-Pokal Open","Vorrunde 2","15","Kiel2","1","1","0","15","12","3"
"DFV-Pokal Open","Vorrunde 2","16","2MUCL","1","0","1","12","15","-3"
"DFV-Pokal Open","Finale 1-8","1"," Bad Skid","1","1","0","15","4","11"
"DFV-Pokal Open","Finale 1-8","2","Frizzly Bears","1","0","1","4","15","-11"
"DFV-Pokal Open","Finale 1-8","3","Family Ultimate","1","1","0","15","13","2"
"DFV-Pokal Open","Finale 1-8","4","FrankN","1","0","1","13","15","-2"
"DFV-Pokal Open","Finale 1-8","5","M.U.C.","1","1","0","15","14","1"
"DFV-Pokal Open","Finale 1-8","6","Hardfisch","1","0","1","14","15","-1"
"DFV-Pokal Open","Finale 1-8","7","7 Schwaben","1","1","0","15","9","6"
"DFV-Pokal Open","Finale 1-8","8","Heidees","1","0","1","9","15","-6"
"DFV-Pokal Open","Finale 9-16","1","Hässliche Erdferkel","1","1","0","15","14","1"
"DFV-Pokal Open","Finale 9-16","2","Funatics","1","0","1","14","15","-1"
"DFV-Pokal Open","Finale 9-16","3","Ars Ludendi","1","1","0","15","8","7"
"DFV-Pokal Open","Finale 9-16","4","Kiel2","1","0","1","8","15","-7"
"DFV-Pokal Open","Finale 9-16","5","Wall City","1","1","0","15","7","8"
"DFV-Pokal Open","Finale 9-16","6","2MUCL","1","0","1","7","15","-8"
"DFV-Pokal Open","Finale 9-16","7","Disckick","1","1","0","15","10","5"
"DFV-Pokal Open","Finale 9-16","8","Hucks Ultimate Berlin","1","0","1","10","15","-5"
"DFV-Pokal Damen","Pool A","1","Mainzelmädchen","2","2","0","30","12","18"
"DFV-Pokal Damen","Pool A","2","JinX","2","1","1","22","15","7"
"DFV-Pokal Damen","Pool A","3","Frankas","2","0","2","5","30","-25"
"DFV-Pokal Damen","Pool B","1","Woodchicas","2","2","0","30","24","6"
"DFV-Pokal Damen","Pool B","2","Heidelbärchen","2","1","1","29","21","8"
"DFV-Pokal Damen","Pool B","3","Black Foxx","2","0","2","16","30","-14"
"DFV-Pokal Damen","Zwischenrunde","1","JinX","1","1","0","15","6","9"
"DFV-Pokal Damen","Zwischenrunde","2","Black Foxx","1","0","1","6","15","-9"
"DFV-Pokal Damen","Zwischenrunde","3","Heidelbärchen","1","1","0","15","2","13"
"DFV-Pokal Damen","Zwischenrunde","4","Frankas","1","0","1","2","15","-13"
"DFV-Pokal Damen","Finale 1-4","1","Mainzelmädchen","1","1","0","15","11","4"
"DFV-Pokal Damen","Finale 1-4","2","Heidelbärchen","1","0","1","11","15","-4"
"DFV-Pokal Damen","Finale 1-4","3","Woodchicas","1","1","0","15","9","6"
"DFV-Pokal Damen","Finale 1-4","4","JinX","1","0","1","9","15","-6"
"DFV-Pokal Damen","Spiel um Platz 5","1","Black Foxx","1","1","0","13","12","1"
"DFV-Pokal Damen","Spiel um Platz 5","2","Frankas","1","0","1","12","13","-1"
"U20 Quali SW","Round Robin","1","Lions","2","2","0","19","7","12"
"U20 Quali SW","Round Robin","2","ToGetHer","2","0","2","7","19","-12"
"U20 Quali NW","Round Robin","1","Äitschbees","6","6","0","44","17","27"
"U20 Quali NW","Round Robin","2","UFO","6","4","2","39","29","10"
"U20 Quali NW","Round Robin","3","Nullacht! Ultimate","6","4","2","36","26","10"
"U20 Quali NW","Round Robin","4","Cologne Colibris","6","3","3","32","33","-1"
"U20 Quali NW","Round Robin","5","Seans's Sheep","6","2","4","34","34","0"
"U20 Quali NW","Round Robin","6","TV Südkamen","6","2","4","31","34","-3"
"U20 Quali NW","Round Robin","7","FischbeesNEXT","6","0","6","6","49","-43"
"U20 Quali NO","Round Robin","1","Disckick","2","1","1","17","16","1"
"U20 Quali NO","Round Robin","2","Pizza Volante","2","1","1","16","17","-1"
"U20 Quali SO","Round Robin","1","Isarrunners","2","2","0","26","7","19"
"U20 Quali SO","Round Robin","2","Münchner Kindl U20","2","1","1","14","18","-4"
"U20 Quali SO","Round Robin","3","Münchner Kindl U17","2","0","2","7","22","-15"
"U17 Quali NO","Round Robin","1","Disckick","3","3","0","27","14","13"
"U17 Quali NO","Round Robin","2","Pizza Volante","3","2","1","27","14","13"
"U17 Quali NO","Round Robin","3","Drehst'n Deckel","3","1","2","18","30","-12"
"U17 Quali NO","Round Robin","4","Pizza Volante II","3","0","3","14","28","-14"
"U17 Quali NO","Finale","1","Disckick","1","1","0","9","6","3"
"U17 Quali NO","Finale","2","Pizza Volante","1","0","1","6","9","-3"
"U17 Quali NO","Finale 3-4","1","Drehst'n Deckel","1","1","0","10","5","5"
"U17 Quali NO","Finale 3-4","2","Pizza Volante II","1","0","1","5","10","-5"
"U17 Quali SW","Round Robin","1","Lions","5","5","0","55","12","43"
"U17 Quali SW","Round Robin","2","Bad Raps","5","4","1","42","17","25"
"U17 Quali SW","Round Robin","3","Piratos","5","3","2","27","27","0"
"U17 Quali SW","Round Robin","4","Kirchheim Ultimate Juniors","5","2","3","24","34","-10"
"U17 Quali SW","Round Robin","5","Eintracht Frankfurt","5","1","4","18","41","-23"
"U17 Quali SW","Round Robin","6","Disconnection Kirchzarten","5","0","5","12","47","-35"
"U17 Quali NW","Round Robin","1","UFO","5","5","0","40","18","22"
"U17 Quali NW","Round Robin","2","TV Südkamen","5","4","1","40","19","21"
"U17 Quali NW","Round Robin","3","Cologne Colibris","5","3","2","35","29","6"
"U17 Quali NW","Round Robin","4","Äitschbees","5","2","3","33","31","2"
"U17 Quali NW","Round Robin","5","Seans's Sheep","5","1","4","21","46","-25"
"U17 Quali NW","Round Robin","6","TV Verl","5","0","5","15","41","-26"
"U14 Quali NO","Round Robin","1","Disckick","4","4","0","34","12","22"
"U14 Quali NO","Round Robin","2","Pizza Volante","4","3","1","32","15","17"
"U14 Quali NO","Round Robin","3","Disckick II","4","2","2","23","22","1"
"U14 Quali NO","Round Robin","4","Pizza Volante II","4","1","3","16","32","-16"
"U14 Quali NO","Round Robin","5","Endzonis","4","0","4","9","33","-24"
"U14 Quali SW","Round Robin","1","Heppie Frisbeez","2","2","0","21","2","19"
"U14 Quali SW","Round Robin","2","Bad Raps","2","1","1","9","11","-2"
"U14 Quali SW","Round Robin","3","Piratos","2","0","2","2","19","-17"
"U14 Quali NW","Round Robin","1","Äitschbees I","4","4","0","41","9","32"
"U14 Quali NW","Round Robin","2","TV Verl","4","3","1","26","24","2"
"U14 Quali NW","Round Robin","3","Seans's Sheep","4","2","2","29","23","6"
"U14 Quali NW","Round Robin","4","Äitschbees II","4","1","3","15","35","-20"
"U14 Quali NW","Round Robin","5","Cologne Colibris","4","0","4","15","35","-20"
"U14 Quali SO","Round Robin","1","Juniorwolves/Lufos","2","2","0","25","3","22"
"U14 Quali SO","Round Robin","2","MuH - Mir uss Haldawang","2","1","1","8","14","-6"
"U14 Quali SO","Round Robin","3","Ultimate am See","2","0","2","3","19","-16"
